45 33 29 26 28 27 30 34 43 42 47 52 63 69 81 93 15 
29 26 27 22 23 24 25 29 30 37 41 47 50 63 68 84 92 
17 15 15 15 19 18 20 21 24 30 37 40 44 54 65 71 77 
4 4 5 6 7 9 11 14 17 23 25 33 37 46 47 58 62 
92 92 93 94 98 99 2 5 11 14 20 25 33 36 42 46 51 
78 79 80 82 83 88 90 95 97 4 7 14 16 25 28 34 36 
64 65 68 69 72 76 82 84 87 94 1 3 5 13 20 22 25 
49 51 53 57 59 65 67 74 77 84 85 93 96 3 4 12 14 
34 37 41 44 49 53 58 63 70 73 79 83 90 93 98 1 6 
21 23 25 30 32 40 43 50 52 61 65 72 74 82 85 91 93 
6 8 13 16 19 27 34 37 40 49 58 61 64 71 78 80 82 
90 93 96 3 7 15 17 26 29 39 42 53 56 63 64 70 72 
72 77 84 90 97 3 11 15 20 29 38 44 52 55 59 61 64 
56 61 65 76 80 92 97 6 10 21 25 35 37 46 48 53 54 
37 44 54 63 69 82 93 98 2 14 24 28 29 38 44 46 47 
17 27 37 54 61 76 80 93 98 9 12 24 27 34 34 40 40 
87 15 33 49 60 73 83 91 97 7 16 22 28 32 35 36 35 
