197 191 188 185 183 180 178 176 175 173 171 169 167 165 164 162 161 159 158 156 155 153 151 149 148 146 145 143 142 140 139 137 135 134 133 131 130 128 127 125 124 122 121 119 117 115 113 111 109 108 106 104 103 101 99 97 94 92 90 88 85 83 80 77 73 
191 189 189 185 184 180 179 177 176 173 172 169 168 166 165 163 162 160 159 157 156 153 152 150 149 147 146 144 143 141 140 138 138 135 134 132 131 129 128 126 125 123 122 120 119 116 115 112 112 109 107 105 104 102 101 98 97 93 92 89 88 84 82 79 77 
188 186 185 184 184 180 178 177 177 173 171 169 169 166 165 164 164 161 159 157 157 154 152 151 151 148 146 144 144 142 141 140 140 137 135 133 133 130 129 127 127 124 122 120 120 117 115 114 114 110 108 106 106 103 101 99 99 95 92 90 89 85 83 81 80 
185 184 183 182 181 179 179 177 176 174 172 169 168 166 166 165 164 162 161 158 156 154 154 152 151 149 148 145 144 143 142 141 140 138 137 134 133 131 130 128 127 125 124 121 120 118 118 116 115 112 111 107 106 104 103 101 99 96 95 91 90 87 86 83 82 
184 182 181 180 179 177 177 176 177 173 171 169 167 166 166 165 166 162 160 158 156 154 153 152 152 149 147 145 144 143 143 142 143 139 137 135 133 131 130 129 129 126 124 122 120 119 118 117 117 113 111 108 106 104 103 101 101 97 95 92 90 88 87 85 85 
181 180 179 178 177 176 176 175 174 172 171 169 169 167 166 165 164 163 162 159 158 155 154 152 151 149 148 146 146 145 144 143 142 140 139 136 135 132 131 129 128 126 125 123 122 120 119 118 117 114 113 110 109 106 104 102 101 98 97 94 94 91 90 88 87 
179 178 177 176 176 174 174 173 172 170 169 168 169 167 166 165 165 163 161 159 159 155 153 151 151 149 148 147 148 146 145 144 143 141 139 137 137 133 131 129 129 126 125 124 124 121 120 119 118 115 113 111 111 107 104 102 102 99 97 96 96 93 91 90 90 
177 176 175 174 174 173 172 171 170 168 168 167 166 166 166 165 165 163 161 159 157 155 154 151 150 149 148 147 147 146 146 145 144 142 141 138 136 134 133 130 129 127 126 124 123 122 121 120 119 116 115 112 110 107 106 103 102 100 99 97 96 94 94 92 92 
176 174 173 172 172 171 170 169 168 167 166 165 165 164 164 164 166 162 160 158 156 154 152 150 149 148 148 147 147 146 146 146 147 143 141 138 136 134 132 130 128 127 126 124 123 122 121 120 121 117 115 112 110 108 106 104 102 101 99 98 97 96 95 94 94 
173 172 172 171 170 169 168 167 167 166 165 164 164 163 163 163 162 161 160 157 157 154 153 151 151 149 148 148 147 147 146 146 145 143 142 139 138 135 134 131 131 128 127 125 124 122 122 121 120 118 117 113 112 109 108 106 105 103 102 100 99 98 97 96 96 
171 170 170 169 169 167 167 166 166 164 164 163 163 162 162 161 160 159 158 157 157 154 153 152 153 150 149 148 148 147 147 146 145 143 142 140 140 136 134 133 133 130 128 126 125 123 122 121 120 118 116 114 114 110 109 108 108 105 103 102 102 100 99 98 98 
169 169 168 168 167 166 166 165 164 163 163 162 161 161 160 159 159 157 157 156 155 154 154 153 152 151 150 149 148 147 147 146 146 144 143 141 139 137 136 134 133 131 129 126 125 123 122 121 120 118 117 114 113 111 111 110 109 107 106 104 103 101 101 100 100 
168 167 167 166 166 164 164 163 164 162 161 160 160 159 159 158 158 156 155 154 154 153 153 153 154 151 150 149 149 147 147 146 147 144 143 141 139 137 136 135 136 132 129 127 125 123 122 121 121 118 116 114 113 112 111 111 112 109 107 105 104 103 102 101 102 
166 166 165 165 164 163 163 162 161 161 160 159 159 158 157 157 156 155 154 153 153 152 152 152 151 151 151 149 149 148 148 147 146 145 144 142 141 138 137 135 134 132 131 128 127 124 123 121 120 118 117 115 115 113 112 112 111 110 109 107 107 105 104 103 103 
165 164 164 163 163 161 161 160 160 159 159 158 158 156 156 155 155 153 153 152 153 151 151 151 151 150 150 149 150 148 148 147 148 145 144 142 142 139 137 135 134 131 130 128 128 124 122 121 120 118 117 116 117 114 113 112 112 110 109 108 109 107 106 105 105 
163 163 162 162 161 160 160 159 158 158 157 157 156 155 155 154 153 152 152 151 151 150 150 150 149 149 149 149 148 148 148 148 148 146 145 142 141 139 138 135 134 131 130 128 127 124 124 121 120 118 118 117 116 115 115 113 112 111 110 109 109 108 108 107 106 
163 161 161 160 160 158 158 157 157 156 156 155 155 154 153 152 152 151 151 150 150 149 149 149 149 148 148 148 148 147 148 148 151 146 144 142 140 138 137 135 133 131 130 128 126 124 123 121 119 119 118 117 117 116 115 114 113 112 111 110 110 109 109 108 108 
160 160 160 159 158 157 157 156 156 155 155 154 154 153 153 152 152 151 150 150 149 149 148 148 148 148 147 147 147 147 147 147 146 145 145 142 142 139 138 136 135 133 131 129 128 126 125 123 123 121 120 119 118 117 116 115 115 113 113 112 111 111 110 110 109 
158 158 158 157 157 156 156 155 156 154 154 153 153 152 152 151 152 150 150 149 149 148 148 147 148 147 147 146 147 146 147 146 145 144 143 142 143 139 138 137 137 134 132 130 130 127 126 125 126 123 122 120 120 118 118 117 117 115 114 113 113 112 112 111 111 
156 156 155 155 155 155 154 154 154 154 153 152 152 151 151 151 151 150 150 149 148 148 147 147 147 147 146 146 146 146 145 145 144 143 143 142 141 139 139 138 137 135 134 131 130 128 128 127 127 126 125 122 121 120 120 119 118 117 116 115 114 114 113 113 113 
155 154 154 153 154 153 153 153 154 152 152 151 151 150 150 150 151 149 149 148 148 147 147 146 147 146 146 145 146 145 145 144 144 142 142 141 140 139 138 138 139 135 133 131 130 129 129 129 130 127 126 124 123 121 121 120 120 118 117 116 116 115 115 114 115 
153 153 153 152 152 152 152 152 151 151 151 150 150 150 149 149 149 149 149 148 147 147 146 146 145 145 145 145 144 144 144 143 143 142 141 140 140 139 138 137 136 135 135 132 132 131 130 130 129 129 128 126 125 123 122 121 120 119 119 118 118 117 116 116 116 
152 151 152 151 151 150 151 150 150 149 150 149 150 149 149 148 149 148 148 147 147 146 146 145 145 144 145 144 144 143 143 142 143 141 141 140 140 138 138 136 136 134 134 133 134 132 132 131 131 130 129 127 127 124 123 122 122 120 120 119 120 118 118 117 118 
150 150 150 150 150 149 149 149 149 148 148 148 148 148 148 148 148 147 147 146 146 145 145 144 144 144 143 143 143 143 142 142 142 141 140 139 139 138 137 136 135 134 134 134 133 133 133 133 133 131 130 128 127 126 125 123 123 122 122 121 120 120 120 119 119 
150 149 149 148 149 148 148 148 148 147 147 147 147 147 147 147 148 146 146 145 145 144 144 143 144 143 143 142 143 142 142 141 142 140 140 138 138 137 136 135 135 134 134 134 134 133 134 134 136 132 131 129 128 127 126 124 124 123 123 122 122 121 121 121 122 
147 147 147 147 147 147 147 147 146 146 146 146 146 146 146 146 145 145 145 144 144 144 143 143 143 143 142 142 141 141 141 141 140 140 139 138 138 137 136 135 135 135 134 134 134 134 134 134 133 133 132 130 130 128 127 126 126 125 124 124 123 123 123 123 123 
146 145 146 145 146 145 146 145 146 145 145 145 145 144 145 144 144 144 144 143 144 143 143 142 143 142 142 141 141 140 141 140 140 139 139 138 138 136 136 135 136 135 135 134 134 134 134 133 133 132 132 131 132 130 129 128 128 126 126 125 125 124 125 124 125 
144 144 144 144 144 144 144 144 144 144 144 144 143 143 143 143 143 143 143 143 142 142 142 142 142 141 141 140 140 140 139 139 139 139 138 138 137 136 136 136 136 135 135 134 134 134 133 133 133 132 132 132 131 131 131 130 129 128 128 127 126 126 126 126 126 
144 143 143 143 144 143 143 143 144 143 143 142 143 142 142 142 142 142 142 142 142 141 141 141 142 140 140 139 140 139 139 138 139 138 138 137 137 136 136 136 137 135 135 134 135 134 134 133 134 132 132 132 132 131 131 131 132 130 129 128 128 127 127 127 128 
142 142 142 142 142 142 142 142 142 142 142 141 141 141 141 141 141 141 141 141 140 140 140 140 140 140 140 139 139 139 138 138 138 138 137 137 137 136 136 136 136 136 136 135 135 135 134 134 133 133 133 132 132 132 132 132 131 131 130 129 129 129 128 128 128 
141 141 141 141 141 140 141 140 141 140 141 140 140 140 140 140 140 140 140 140 140 139 140 139 139 139 139 138 139 138 138 137 138 137 137 136 137 136 136 136 136 136 136 135 136 135 135 134 134 133 133 132 133 132 133 132 132 131 131 130 131 130 130 129 130 
140 140 140 140 139 139 139 139 139 139 139 139 139 139 139 139 139 139 139 139 139 139 138 138 138 138 138 138 137 137 137 137 137 137 136 136 136 136 136 136 136 136 136 136 135 135 135 134 134 134 133 133 133 133 133 133 133 132 132 132 131 131 131 131 131 
140 139 139 138 139 138 138 138 139 138 138 138 138 138 138 138 138 138 138 138 138 138 138 137 138 137 137 137 137 136 137 136 137 136 136 136 136 136 136 136 136 136 136 136 136 135 135 134 135 134 134 134 134 134 134 134 134 133 133 133 133 132 133 133 134 
137 137 137 137 137 137 137 137 137 137 137 137 137 137 137 137 137 137 137 137 137 137 137 137 136 136 136 136 136 136 136 136 136 136 136 136 136 136 136 136 136 136 136 136 135 135 135 135 135 135 135 135 135 135 135 135 134 134 134 134 134 134 134 134 134 
136 135 136 135 136 135 136 135 136 136 136 136 136 136 136 136 136 136 136 136 136 136 136 136 136 135 136 135 136 136 136 136 136 136 136 136 136 136 136 136 136 136 137 136 136 135 136 135 136 136 136 136 136 136 136 136 136 135 136 135 136 135 136 135 136 
134 134 134 134 134 134 134 134 134 135 135 135 135 135 135 135 135 135 135 135 135 135 135 135 135 135 135 135 135 136 136 136 136 136 136 136 136 136 136 136 136 137 137 137 137 136 136 136 136 137 137 137 137 137 137 137 137 137 137 137 137 137 137 137 137 
134 133 133 133 134 133 133 133 134 133 134 134 134 134 134 134 135 134 134 134 135 134 135 134 135 134 135 135 136 135 136 136 137 136 136 136 137 136 137 137 138 137 138 137 138 137 137 137 138 137 138 138 138 138 138 138 139 138 138 138 139 138 138 138 139 
132 132 132 132 132 132 132 132 132 132 132 133 133 133 133 133 133 133 133 133 133 134 134 134 134 134 134 135 135 135 135 136 136 136 136 136 136 137 137 137 137 138 138 138 138 138 138 138 138 138 138 139 139 139 139 139 139 139 139 139 139 139 139 139 139 
131 130 131 130 131 131 131 131 131 131 132 132 132 132 132 132 132 132 133 132 133 133 134 133 134 134 135 134 135 135 136 136 136 136 137 136 137 137 138 137 138 138 139 138 139 138 139 139 139 139 140 140 140 140 140 140 140 140 141 140 141 140 141 140 141 
129 129 129 129 129 130 130 130 130 130 130 131 131 131 131 131 131 132 132 132 132 133 133 133 133 134 134 134 134 135 135 136 136 136 136 137 137 137 137 138 138 139 138 139 139 139 139 140 140 140 140 141 141 141 141 141 141 142 141 142 142 142 142 142 142 
129 128 128 128 129 128 129 129 130 129 130 130 130 130 130 130 132 131 132 132 133 132 133 133 134 133 134 134 135 134 135 135 137 136 137 137 138 137 138 138 140 139 139 139 140 139 140 140 142 141 142 142 142 142 142 142 144 143 143 143 144 143 144 144 145 
127 127 127 127 127 127 127 128 128 128 128 129 129 129 129 130 130 131 131 131 131 132 132 132 132 133 133 134 134 134 134 135 135 136 136 137 137 138 138 139 138 139 139 140 140 140 140 141 141 142 142 143 143 143 143 144 143 144 144 144 144 145 145 145 145 
126 125 126 125 126 126 127 126 127 127 128 128 128 128 129 129 129 130 131 130 131 131 132 131 132 132 134 134 134 134 135 135 135 136 137 137 138 138 139 139 139 139 140 140 141 141 142 142 142 143 144 144 144 144 145 145 145 145 146 145 146 146 147 146 147 
124 124 124 124 124 125 125 125 125 126 126 127 127 127 127 128 128 129 129 130 130 131 131 131 131 132 132 134 134 134 134 135 135 136 136 137 137 138 138 139 139 140 140 141 141 142 142 143 143 144 144 145 145 145 145 146 146 147 147 147 147 148 148 148 148 
123 122 123 123 124 123 124 124 125 125 126 126 127 126 127 127 128 128 129 129 131 130 131 131 132 132 133 133 135 134 135 135 136 136 137 137 139 138 139 139 140 140 141 141 143 142 143 143 145 145 146 146 147 146 147 147 148 148 149 149 150 149 150 150 151 
121 121 121 122 122 122 122 123 123 124 124 125 125 126 126 126 126 127 128 129 129 130 130 131 131 132 132 133 133 134 134 135 135 136 137 138 138 139 139 140 140 141 141 142 142 143 143 144 144 146 146 147 147 148 148 148 148 149 149 150 150 151 151 152 152 
120 120 121 120 121 121 122 122 122 123 124 124 124 125 126 125 126 126 128 128 128 129 130 130 131 132 133 133 133 134 135 135 136 136 138 138 138 139 140 140 141 141 142 142 143 143 145 145 146 147 148 148 148 149 150 149 150 150 152 151 152 152 154 154 154 
119 119 119 119 119 120 120 121 121 122 122 123 123 124 124 125 125 126 126 127 127 128 128 130 131 132 132 133 133 134 134 136 136 137 137 138 138 139 139 141 141 142 142 143 143 144 144 146 147 148 148 149 149 150 150 151 151 152 152 153 153 154 154 156 156 
118 117 118 118 119 118 119 119 121 120 121 121 123 123 124 124 126 125 126 126 128 128 129 130 132 131 132 132 134 134 135 136 138 137 138 138 140 140 141 141 143 142 143 143 145 145 146 147 150 149 150 150 151 151 152 152 154 153 154 154 156 156 157 157 159 
116 116 116 117 117 117 117 118 118 119 119 120 120 122 122 123 123 124 125 126 126 127 128 129 129 130 131 132 132 134 134 135 135 137 137 138 138 140 140 141 141 142 143 144 144 145 146 147 147 149 150 151 151 152 152 153 153 155 155 156 156 157 158 159 159 
115 114 115 115 116 116 117 116 117 118 119 119 120 121 122 122 122 123 125 125 126 126 128 128 128 129 131 131 132 133 135 134 135 136 138 138 139 140 141 141 141 142 144 144 145 145 147 147 148 149 151 151 152 153 154 154 155 156 157 157 158 158 160 160 161 
113 113 113 114 114 115 115 115 116 117 117 118 119 120 120 121 121 122 123 125 125 126 126 127 128 129 129 131 132 133 133 134 135 136 136 138 139 140 140 141 141 142 143 145 145 146 146 148 148 150 150 152 153 154 154 155 156 157 157 159 159 160 160 162 162 
112 111 112 112 114 113 114 114 115 116 117 117 119 119 120 120 121 121 123 124 126 126 127 127 128 129 130 131 133 133 134 134 135 135 137 138 140 140 141 141 142 142 144 145 147 147 148 148 149 150 152 153 155 155 156 156 158 158 160 160 162 162 163 163 164 
110 110 110 111 111 112 112 113 113 115 115 116 116 118 118 119 119 121 121 123 123 125 126 127 127 129 129 130 130 132 133 134 134 135 136 138 138 140 141 142 142 143 144 145 145 147 148 149 149 151 151 153 153 156 157 158 158 160 160 162 162 163 164 165 165 
109 109 110 109 110 110 112 112 113 114 115 115 115 116 118 118 119 120 122 122 123 125 127 127 128 129 130 130 130 131 133 133 134 135 137 137 138 140 142 142 143 144 146 146 146 147 149 149 150 151 153 153 154 156 159 159 160 161 163 163 163 164 166 166 167 
107 107 107 108 108 109 109 111 112 113 113 114 115 116 116 118 118 120 120 122 123 125 125 127 128 129 129 130 131 132 132 133 134 135 136 138 138 140 140 143 144 145 145 147 147 148 148 150 150 152 152 154 155 158 158 161 162 163 163 165 165 166 166 168 169 
106 105 106 106 108 108 109 110 112 112 113 113 115 115 116 117 119 119 121 122 124 124 126 127 130 129 130 130 132 132 133 133 135 135 137 138 140 140 142 143 146 145 147 147 149 149 150 150 152 152 154 155 158 159 161 162 165 164 166 166 168 168 169 170 172 
104 104 104 105 105 107 107 109 109 111 111 112 112 114 115 116 116 119 119 121 121 124 124 126 126 129 129 130 130 132 133 134 134 136 136 138 138 141 141 143 143 145 146 147 147 149 150 151 151 153 154 156 156 159 160 162 162 165 166 168 168 170 170 172 173 
102 102 103 103 104 105 107 107 108 109 111 111 112 113 115 115 116 118 120 120 121 123 125 125 126 128 130 130 131 132 134 134 135 136 138 138 139 141 143 143 143 145 147 147 148 149 151 151 152 154 156 157 158 160 162 162 163 165 168 169 170 171 173 174 175 
100 100 100 102 102 104 104 106 106 108 109 111 112 113 113 115 115 117 118 120 121 123 123 125 125 127 128 130 131 133 133 134 135 137 137 139 140 141 141 143 143 145 145 148 149 150 150 152 153 155 155 158 159 161 161 163 164 166 167 170 171 173 174 176 177 
98 98 99 100 102 102 104 105 106 107 109 110 113 113 114 114 116 117 119 120 123 123 124 124 125 127 129 130 133 133 134 134 136 137 139 140 142 142 143 143 144 145 147 148 151 151 152 153 154 156 158 159 162 162 163 164 165 167 170 172 175 175 177 178 180 
96 96 97 98 99 101 102 104 104 106 107 109 109 112 113 114 115 117 118 120 120 122 123 124 125 127 127 130 130 133 134 135 135 137 138 140 140 142 143 144 144 146 147 149 149 151 152 154 154 157 157 160 160 162 163 165 166 169 170 173 173 177 178 181 182 
94 94 96 97 98 100 102 103 104 106 108 108 109 111 114 114 115 117 119 119 120 122 124 124 126 127 129 129 130 132 135 135 136 137 140 140 140 142 144 144 145 147 149 149 150 152 154 155 156 158 160 160 160 162 165 166 168 170 173 174 175 178 182 183 185 
91 93 94 96 97 99 100 103 104 106 106 109 110 112 112 115 115 117 117 120 120 122 122 125 126 128 128 130 131 133 133 136 137 138 138 140 141 143 143 145 146 148 148 150 151 153 153 156 157 159 159 161 162 164 164 168 169 172 172 175 177 180 181 186 188 
88 91 94 96 98 99 101 103 105 106 108 109 111 112 114 115 117 117 119 120 122 122 124 125 128 128 130 131 133 133 135 136 139 139 140 141 143 143 145 146 148 148 150 151 153 153 155 157 160 160 161 162 164 165 167 169 172 173 175 176 180 181 185 188 193 
