65
65
1233 1281 1315 1341 1364 1390 1420 1434 1463 1487 1528 1561 1610 1632 1679 1730 1818 1801 1823 1832 1854 1880 1913 1941 1988 2014 2063 2094 2144 2172 2235 2287 2392 2358 2367 2386 2427 2435 2459 2486 2537 2556 2591 2618 2666 2692 2739 2790 2875 2863 2894 2926 2979 3003 3049 3091 3161 3179 3232 3289 3376 3412 3483 3564 3690 
1283 1296 1305 1345 1349 1386 1395 1420 1432 1472 1498 1546 1554 1608 1631 1695 1694 1763 1793 1820 1836 1874 1887 1922 1937 1993 2023 2076 2085 2139 2165 2234 2237 2316 2345 2366 2379 2421 2437 2463 2478 2540 2555 2597 2611 2672 2699 2758 2759 2821 2858 2906 2918 2981 3007 3063 3073 3145 3187 3259 3278 3378 3420 3519 3568 
1321 1330 1349 1356 1353 1386 1410 1414 1419 1461 1512 1527 1534 1579 1611 1634 1640 1712 1774 1804 1830 1863 1899 1907 1920 1978 2035 2053 2063 2107 2146 2163 2165 2244 2308 2337 2364 2404 2437 2445 2453 2506 2547 2572 2585 2644 2701 2710 2718 2774 2830 2865 2891 2949 3008 3023 3036 3111 3185 3221 3246 3330 3408 3452 3496 
1352 1354 1362 1379 1386 1398 1391 1407 1412 1441 1462 1517 1535 1563 1562 1593 1610 1671 1703 1793 1812 1851 1854 1889 1911 1965 1977 2041 2052 2081 2079 2109 2126 2189 2221 2311 2341 2395 2396 2430 2446 2487 2504 2559 2578 2619 2626 2666 2685 2729 2759 2833 2859 2919 2930 2986 3012 3079 3107 3195 3225 3290 3307 3386 3416 
1381 1384 1397 1403 1420 1412 1409 1405 1393 1435 1473 1506 1550 1545 1558 1564 1565 1640 1708 1758 1830 1829 1846 1870 1893 1937 1982 2010 2052 2050 2064 2070 2063 2146 2222 2278 2353 2370 2397 2414 2433 2476 2517 2550 2587 2605 2636 2644 2644 2705 2757 2805 2854 2890 2926 2955 2975 3049 3120 3167 3231 3260 3308 3340 3367 
1400 1407 1411 1418 1413 1422 1416 1412 1422 1434 1445 1487 1482 1510 1527 1543 1565 1619 1629 1701 1717 1792 1817 1853 1863 1910 1921 1965 1973 2005 2025 2047 2064 2112 2141 2227 2247 2338 2364 2398 2423 2470 2486 2539 2538 2580 2603 2633 2650 2693 2711 2777 2791 2862 2888 2936 2958 3025 3045 3122 3133 3212 3243 3300 3311 
1413 1419 1438 1428 1417 1420 1413 1421 1434 1447 1469 1474 1459 1493 1508 1526 1543 1588 1631 1658 1668 1745 1795 1828 1846 1891 1919 1937 1940 1974 1998 2018 2034 2090 2164 2190 2203 2299 2367 2398 2430 2469 2503 2520 2519 2571 2613 2626 2640 2688 2732 2755 2768 2841 2900 2924 2946 3003 3059 3080 3080 3164 3229 3251 3267 
1417 1419 1427 1440 1436 1431 1425 1427 1432 1453 1460 1483 1486 1495 1494 1511 1524 1562 1583 1635 1668 1725 1742 1818 1844 1890 1888 1925 1929 1953 1959 1993 2000 2053 2086 2169 2210 2288 2304 2398 2426 2474 2481 2520 2538 2573 2578 2621 2638 2687 2696 2745 2777 2834 2847 2915 2934 2982 3000 3060 3086 3136 3143 3210 3235 
1420 1430 1439 1442 1437 1432 1427 1434 1436 1455 1473 1483 1500 1503 1513 1512 1515 1554 1594 1633 1681 1713 1758 1804 1874 1870 1891 1903 1921 1937 1953 1963 1957 2027 2089 2148 2220 2267 2330 2381 2465 2464 2500 2518 2559 2575 2601 2615 2631 2674 2713 2747 2799 2826 2872 2899 2942 2968 3014 3044 3089 3109 3148 3178 3230 
1440 1444 1445 1453 1442 1433 1443 1448 1451 1459 1464 1477 1483 1505 1503 1511 1522 1545 1567 1624 1628 1690 1714 1768 1768 1826 1856 1877 1893 1923 1932 1950 1967 2012 2033 2115 2134 2231 2263 2332 2343 2417 2454 2494 2517 2568 2584 2608 2626 2667 2680 2731 2741 2802 2822 2869 2879 2934 2964 3014 3019 3066 3081 3126 3146 
1456 1456 1463 1457 1444 1449 1456 1462 1473 1478 1487 1483 1480 1493 1497 1506 1522 1546 1584 1600 1605 1663 1717 1725 1723 1788 1850 1862 1881 1908 1937 1940 1954 2001 2049 2086 2104 2193 2270 2288 2296 2376 2442 2482 2508 2562 2604 2614 2631 2664 2693 2714 2720 2780 2818 2833 2844 2905 2968 2977 2985 3023 3044 3069 3083 
1460 1463 1465 1470 1467 1463 1465 1473 1476 1493 1489 1491 1493 1493 1491 1497 1509 1536 1552 1589 1605 1643 1647 1692 1702 1755 1771 1841 1861 1891 1893 1921 1940 1990 2008 2076 2108 2170 2182 2255 2274 2350 2385 2487 2513 2570 2576 2614 2630 2666 2678 2714 2740 2782 2772 2802 2822 2875 2889 2942 2965 2997 2995 3025 3036 
1462 1468 1472 1475 1472 1474 1482 1482 1482 1493 1499 1495 1501 1496 1497 1503 1507 1538 1563 1580 1604 1627 1649 1656 1647 1714 1768 1809 1865 1867 1881 1898 1912 1965 2013 2066 2140 2162 2201 2220 2223 2323 2410 2474 2556 2574 2615 2623 2638 2673 2704 2727 2771 2774 2787 2790 2793 2852 2895 2922 2954 2961 2974 2987 3001 
1470 1475 1480 1489 1483 1482 1490 1491 1496 1498 1492 1491 1496 1495 1505 1512 1522 1548 1544 1565 1576 1612 1621 1637 1656 1687 1702 1764 1777 1833 1855 1880 1897 1948 1970 2035 2054 2137 2163 2204 2241 2310 2341 2445 2459 2557 2592 2627 2646 2686 2690 2722 2719 2756 2760 2778 2801 2845 2851 2900 2892 2920 2929 2948 2956 
1475 1483 1494 1492 1489 1495 1518 1511 1514 1506 1497 1497 1499 1506 1515 1519 1531 1545 1559 1568 1567 1604 1631 1639 1654 1687 1713 1739 1743 1802 1845 1863 1882 1931 1986 2020 2033 2114 2174 2215 2252 2325 2388 2424 2427 2538 2630 2641 2657 2692 2716 2706 2697 2727 2737 2767 2797 2830 2866 2866 2856 2883 2897 2914 2921 
1486 1489 1488 1498 1492 1494 1505 1521 1523 1516 1512 1503 1504 1515 1512 1520 1524 1543 1555 1582 1588 1608 1610 1637 1658 1697 1702 1737 1752 1789 1795 1848 1859 1910 1948 2029 2055 2114 2141 2230 2273 2352 2360 2437 2466 2539 2554 2653 2688 2712 2685 2690 2705 2720 2724 2759 2773 2814 2815 2842 2851 2860 2864 2890 2900 
1495 1493 1493 1490 1485 1499 1518 1525 1537 1521 1517 1510 1502 1512 1515 1517 1519 1541 1565 1581 1606 1611 1628 1640 1669 1691 1723 1739 1770 1782 1800 1822 1833 1903 1971 2026 2094 2127 2190 2243 2338 2348 2399 2437 2502 2538 2599 2655 2760 2695 2683 2681 2697 2706 2720 2744 2785 2790 2808 2819 2838 2842 2852 2867 2891 
1498 1497 1493 1485 1494 1500 1510 1524 1516 1515 1526 1520 1520 1517 1514 1514 1525 1540 1552 1571 1576 1602 1610 1626 1639 1675 1695 1726 1739 1772 1784 1810 1833 1899 1928 2010 2024 2111 2143 2214 2221 2304 2348 2413 2435 2514 2541 2610 2587 2628 2658 2654 2668 2689 2690 2714 2720 2756 2768 2789 2795 2818 2827 2838 2852 
1502 1498 1498 1495 1499 1510 1533 1522 1508 1520 1533 1528 1528 1525 1524 1526 1532 1550 1578 1570 1568 1589 1609 1614 1630 1669 1710 1724 1735 1765 1786 1802 1823 1893 1971 1993 2006 2089 2155 2173 2176 2263 2337 2382 2416 2477 2539 2530 2511 2554 2593 2618 2646 2653 2662 2677 2690 2717 2743 2754 2767 2792 2817 2813 2827 
1503 1495 1499 1499 1502 1511 1511 1524 1524 1527 1523 1533 1528 1531 1529 1534 1534 1553 1549 1565 1573 1580 1579 1594 1615 1663 1677 1727 1738 1770 1769 1789 1813 1880 1905 1986 2027 2085 2088 2149 2165 2236 2263 2362 2389 2439 2433 2461 2465 2484 2516 2582 2591 2618 2625 2643 2653 2682 2690 2718 2738 2767 2759 2773 2783 
1513 1501 1500 1501 1502 1509 1513 1515 1513 1519 1524 1523 1518 1521 1524 1522 1525 1538 1547 1559 1569 1570 1575 1585 1595 1645 1688 1714 1745 1760 1782 1786 1797 1866 1932 1983 2067 2077 2114 2124 2121 2205 2279 2337 2419 2405 2416 2407 2379 2439 2488 2530 2571 2576 2593 2608 2627 2648 2670 2693 2724 2724 2729 2737 2751 
1500 1498 1501 1504 1502 1512 1508 1511 1512 1512 1519 1520 1514 1511 1508 1508 1519 1527 1540 1558 1549 1559 1567 1579 1593 1634 1649 1698 1705 1746 1759 1779 1805 1856 1874 1950 1965 2042 2076 2114 2138 2187 2210 2290 2284 2346 2367 2375 2385 2405 2418 2479 2476 2523 2544 2570 2581 2616 2631 2661 2659 2677 2689 2697 2710 
1490 1489 1489 1492 1495 1501 1507 1510 1512 1522 1534 1517 1504 1500 1498 1505 1519 1529 1550 1544 1534 1549 1561 1574 1586 1627 1670 1685 1691 1732 1769 1783 1803 1850 1895 1929 1938 2023 2083 2115 2139 2190 2242 2246 2223 2290 2329 2333 2345 2369 2409 2423 2417 2472 2513 2534 2547 2585 2621 2624 2630 2646 2658 2669 2683 
1479 1479 1479 1481 1483 1492 1498 1513 1522 1531 1516 1512 1501 1490 1495 1496 1498 1520 1527 1537 1541 1545 1550 1570 1574 1619 1632 1683 1693 1722 1739 1784 1800 1847 1868 1933 1967 2029 2044 2126 2141 2192 2188 2230 2242 2265 2254 2285 2289 2319 2346 2389 2409 2437 2452 2506 2523 2557 2558 2586 2602 2619 2623 2639 2654 
1470 1465 1467 1466 1473 1481 1495 1507 1540 1519 1509 1495 1471 1483 1490 1485 1478 1510 1533 1534 1533 1545 1554 1559 1547 1601 1641 1673 1699 1727 1762 1779 1803 1844 1890 1939 2012 2039 2086 2115 2166 2167 2192 2202 2232 2233 2245 2242 2223 2281 2331 2362 2402 2413 2448 2471 2518 2522 2542 2557 2584 2588 2607 2616 2640 
1454 1447 1450 1446 1454 1467 1462 1480 1482 1499 1505 1489 1490 1482 1478 1478 1492 1510 1515 1534 1537 1549 1556 1568 1579 1600 1616 1670 1674 1725 1735 1770 1784 1836 1861 1923 1945 2030 2045 2084 2080 2121 2134 2154 2166 2192 2209 2217 2230 2254 2265 2326 2326 2365 2385 2413 2423 2474 2489 2519 2520 2545 2556 2579 2591 
1447 1441 1439 1435 1438 1434 1430 1449 1455 1475 1494 1483 1483 1478 1484 1484 1493 1514 1539 1536 1533 1556 1576 1584 1595 1619 1650 1662 1661 1709 1746 1759 1769 1831 1885 1918 1938 2003 2054 2042 2031 2070 2096 2117 2128 2161 2196 2199 2207 2229 2258 2280 2284 2327 2361 2362 2359 2410 2446 2464 2475 2500 2516 2537 2554 
1437 1433 1428 1418 1410 1403 1417 1434 1435 1453 1453 1466 1467 1463 1475 1482 1490 1514 1514 1539 1554 1569 1573 1597 1606 1632 1639 1669 1682 1706 1717 1752 1778 1835 1852 1928 1946 1990 1978 2000 2012 2034 2051 2090 2100 2128 2141 2178 2178 2197 2217 2254 2269 2300 2298 2318 2325 2363 2373 2416 2429 2466 2473 2501 2512 
1432 1421 1414 1402 1381 1391 1396 1411 1425 1434 1441 1446 1446 1454 1472 1473 1480 1497 1513 1537 1571 1578 1596 1602 1622 1635 1662 1674 1703 1723 1749 1760 1779 1830 1878 1922 1981 1975 1987 1979 1962 2010 2050 2067 2089 2112 2133 2143 2144 2180 2212 2238 2265 2275 2293 2285 2261 2320 2354 2372 2391 2426 2453 2469 2482 
1417 1408 1410 1396 1395 1386 1385 1392 1393 1417 1419 1434 1432 1437 1447 1461 1465 1484 1496 1526 1535 1577 1582 1595 1606 1626 1639 1665 1686 1734 1742 1763 1782 1828 1852 1903 1902 1943 1961 1970 1983 1995 2004 2041 2056 2098 2102 2119 2137 2167 2178 2221 2218 2244 2258 2271 2285 2302 2294 2328 2347 2395 2405 2441 2443 
1412 1406 1407 1389 1385 1374 1382 1374 1368 1387 1402 1412 1418 1426 1446 1441 1446 1468 1497 1516 1525 1563 1585 1596 1610 1629 1643 1668 1684 1726 1768 1776 1790 1840 1899 1898 1887 1926 1951 1968 1982 1998 2021 2032 2036 2073 2103 2117 2131 2161 2182 2196 2195 2230 2255 2264 2276 2283 2288 2305 2311 2362 2393 2404 2406 
1402 1397 1387 1370 1360 1346 1353 1354 1359 1362 1374 1397 1401 1406 1407 1412 1425 1446 1471 1517 1530 1567 1568 1597 1615 1639 1648 1682 1687 1720 1736 1784 1805 1846 1853 1903 1911 1925 1931 1970 1980 1995 2002 2030 2033 2055 2074 2118 2135 2167 2164 2187 2199 2226 2224 2254 2260 2268 2278 2294 2317 2352 2344 2376 2383 
1399 1383 1370 1347 1320 1329 1329 1337 1339 1354 1371 1384 1400 1394 1393 1396 1397 1438 1476 1501 1541 1556 1586 1601 1641 1645 1664 1682 1705 1724 1757 1780 1823 1839 1874 1891 1920 1926 1943 1969 2007 1992 2004 2014 2029 2049 2087 2110 2153 2154 2171 2176 2201 2205 2223 2237 2264 2261 2277 2294 2335 2332 2339 2354 2367 
1368 1366 1354 1329 1331 1323 1319 1328 1327 1347 1349 1368 1368 1378 1381 1385 1400 1433 1435 1471 1485 1533 1550 1580 1595 1638 1656 1678 1683 1717 1727 1756 1768 1816 1833 1868 1878 1918 1930 1957 1946 1965 1982 1996 2004 2027 2043 2085 2083 2126 2135 2145 2153 2172 2188 2210 2212 2236 2248 2271 2275 2304 2316 2335 2337 
1341 1332 1322 1307 1305 1303 1307 1307 1305 1328 1344 1354 1358 1363 1362 1377 1390 1416 1439 1456 1460 1513 1548 1564 1578 1625 1670 1671 1674 1705 1733 1737 1745 1787 1825 1843 1853 1893 1927 1926 1921 1938 1961 1975 1991 2006 2034 2039 2034 2076 2117 2120 2125 2146 2172 2178 2181 2206 2222 2239 2251 2276 2293 2301 2310 
1307 1302 1296 1272 1274 1277 1285 1291 1299 1316 1318 1348 1351 1357 1360 1374 1375 1404 1419 1454 1474 1513 1511 1550 1566 1616 1622 1665 1679 1696 1694 1714 1731 1762 1781 1827 1841 1874 1876 1901 1903 1908 1922 1955 1954 1972 1984 2006 2007 2030 2050 2094 2097 2118 2127 2149 2159 2188 2192 2213 2229 2256 2249 2268 2274 
1279 1274 1269 1250 1226 1254 1270 1275 1282 1292 1304 1328 1357 1350 1354 1360 1361 1396 1429 1451 1491 1503 1524 1540 1553 1591 1631 1650 1686 1686 1693 1702 1718 1750 1792 1812 1840 1858 1878 1880 1878 1896 1906 1927 1931 1952 1967 1969 1959 2004 2043 2057 2061 2092 2116 2129 2130 2159 2187 2199 2225 2224 2223 2236 2246 
1252 1249 1245 1234 1243 1246 1241 1259 1253 1267 1279 1304 1308 1334 1344 1351 1362 1391 1394 1433 1442 1485 1503 1535 1538 1566 1580 1618 1631 1671 1676 1683 1698 1729 1747 1789 1798 1840 1846 1866 1877 1893 1894 1918 1919 1939 1939 1944 1958 1986 1995 2033 2043 2075 2089 2122 2121 2134 2144 2172 2173 2195 2198 2210 2211 
1229 1230 1219 1223 1223 1229 1236 1229 1219 1243 1266 1283 1290 1314 1337 1342 1352 1376 1393 1413 1422 1467 1504 1522 1530 1560 1584 1598 1606 1640 1667 1672 1687 1713 1753 1763 1772 1808 1838 1856 1871 1884 1888 1908 1915 1930 1944 1940 1938 1969 2005 2016 2024 2064 2101 2111 2112 2131 2140 2146 2139 2156 2163 2174 2177 
1221 1223 1217 1216 1210 1214 1203 1202 1202 1222 1234 1272 1277 1295 1305 1329 1347 1368 1374 1404 1421 1459 1471 1522 1540 1562 1559 1585 1602 1619 1623 1653 1662 1686 1702 1741 1756 1784 1805 1852 1865 1884 1890 1912 1911 1925 1924 1935 1933 1950 1969 2004 2025 2058 2066 2109 2124 2140 2128 2133 2131 2128 2133 2146 2149 
1213 1202 1201 1195 1192 1182 1174 1168 1148 1192 1223 1247 1278 1287 1308 1321 1354 1353 1373 1391 1430 1447 1483 1517 1574 1556 1562 1580 1622 1609 1614 1627 1644 1664 1695 1719 1747 1772 1814 1839 1887 1880 1893 1901 1921 1921 1923 1923 1904 1948 1985 2005 2034 2048 2076 2097 2147 2127 2130 2124 2124 2119 2120 2124 2124 
1183 1173 1176 1172 1168 1151 1154 1151 1165 1176 1185 1216 1225 1269 1277 1296 1295 1317 1336 1357 1372 1419 1441 1490 1487 1529 1540 1554 1556 1581 1590 1599 1606 1631 1652 1695 1701 1746 1763 1806 1811 1856 1866 1880 1896 1916 1922 1930 1936 1956 1956 1997 1995 2026 2035 2059 2062 2094 2107 2110 2112 2104 2109 2109 2109 
1164 1159 1148 1151 1150 1139 1123 1139 1162 1177 1203 1199 1194 1234 1266 1260 1259 1285 1316 1331 1341 1387 1425 1441 1446 1484 1503 1520 1530 1553 1558 1571 1582 1610 1638 1659 1671 1714 1754 1765 1769 1814 1844 1874 1897 1914 1924 1930 1938 1950 1968 1975 1972 2001 2024 2024 2022 2055 2080 2092 2106 2099 2101 2094 2094 
1149 1151 1144 1135 1133 1133 1129 1123 1136 1169 1166 1184 1189 1209 1202 1222 1229 1251 1267 1310 1323 1365 1368 1406 1421 1460 1466 1496 1515 1543 1538 1546 1559 1591 1602 1632 1652 1688 1700 1733 1751 1787 1818 1878 1893 1919 1917 1931 1934 1941 1948 1963 1969 1982 1979 1992 1998 2024 2040 2073 2084 2086 2084 2073 2075 
1133 1127 1127 1118 1118 1112 1111 1117 1131 1145 1150 1157 1160 1176 1185 1187 1178 1221 1251 1278 1302 1332 1362 1378 1394 1431 1465 1487 1520 1524 1533 1538 1543 1574 1604 1627 1650 1681 1709 1723 1732 1783 1838 1875 1933 1920 1924 1931 1941 1943 1950 1955 1963 1970 1972 1969 1953 2004 2041 2060 2099 2074 2072 2062 2059 
1108 1099 1100 1093 1097 1088 1096 1104 1111 1130 1134 1137 1142 1153 1153 1163 1176 1205 1210 1249 1258 1299 1320 1351 1368 1406 1428 1468 1470 1502 1516 1531 1540 1560 1578 1624 1632 1679 1687 1719 1734 1778 1793 1853 1856 1905 1925 1929 1937 1943 1940 1947 1952 1965 1959 1961 1976 2000 1995 2027 2027 2042 2054 2046 2042 
1093 1084 1078 1079 1083 1079 1075 1090 1100 1115 1141 1133 1130 1137 1138 1142 1152 1182 1209 1228 1234 1283 1330 1340 1353 1399 1444 1449 1445 1484 1513 1526 1537 1561 1588 1607 1624 1669 1703 1721 1733 1771 1811 1829 1830 1885 1933 1938 1953 1944 1931 1942 1947 1953 1949 1960 1972 1987 2002 2000 1999 2014 2031 2023 2023 
1068 1067 1069 1065 1066 1073 1073 1082 1079 1092 1103 1127 1127 1129 1120 1117 1130 1163 1180 1221 1238 1270 1281 1328 1355 1394 1399 1440 1456 1478 1485 1525 1531 1561 1562 1593 1620 1670 1679 1731 1741 1764 1774 1824 1838 1874 1883 1940 1951 1949 1944 1944 1940 1951 1950 1960 1957 1975 1968 1974 1985 1986 1987 1994 1991 
1046 1049 1051 1053 1048 1055 1057 1062 1067 1077 1094 1101 1113 1108 1106 1106 1104 1152 1187 1216 1254 1268 1294 1321 1370 1384 1412 1431 1462 1474 1493 1508 1527 1541 1560 1590 1632 1658 1691 1719 1768 1758 1778 1805 1845 1858 1890 1926 1984 1946 1931 1933 1935 1939 1944 1946 1945 1947 1951 1960 1979 1969 1969 1961 1956 
1038 1033 1040 1049 1044 1044 1043 1044 1043 1058 1055 1071 1076 1086 1092 1099 1119 1155 1161 1203 1208 1256 1265 1295 1310 1361 1378 1412 1423 1465 1471 1488 1491 1519 1537 1575 1590 1642 1655 1686 1688 1722 1746 1776 1785 1824 1848 1893 1885 1923 1934 1924 1926 1929 1929 1936 1926 1920 1928 1938 1936 1943 1940 1927 1928 
1037 1030 1032 1034 1035 1035 1039 1027 1016 1026 1024 1044 1055 1063 1070 1092 1116 1148 1183 1190 1188 1233 1256 1276 1292 1333 1372 1391 1403 1442 1471 1464 1464 1494 1527 1557 1583 1624 1663 1658 1655 1690 1721 1745 1762 1798 1831 1837 1837 1876 1908 1908 1922 1913 1916 1911 1907 1906 1911 1909 1913 1911 1913 1907 1903 
1022 1019 1019 1022 1017 1023 1015 1009 1010 1007 1013 1027 1030 1044 1061 1086 1099 1141 1153 1187 1211 1232 1230 1261 1269 1307 1329 1379 1395 1429 1420 1436 1443 1467 1488 1543 1565 1608 1606 1631 1641 1665 1681 1723 1737 1775 1767 1787 1805 1836 1846 1878 1880 1885 1886 1886 1889 1887 1883 1877 1879 1878 1885 1886 1884 
1010 1005 999 1001 993 999 996 994 985 993 1005 1018 1027 1038 1059 1079 1100 1127 1168 1192 1243 1231 1242 1252 1255 1298 1341 1362 1401 1400 1412 1407 1399 1443 1479 1525 1585 1590 1604 1605 1605 1644 1681 1700 1730 1736 1746 1757 1767 1801 1834 1842 1851 1853 1854 1860 1869 1865 1863 1855 1853 1857 1866 1865 1865 
993 995 998 993 990 986 983 986 980 977 990 1013 1011 1024 1040 1071 1071 1101 1122 1173 1171 1208 1228 1250 1260 1290 1295 1330 1334 1359 1372 1381 1396 1428 1439 1494 1503 1565 1574 1581 1599 1627 1634 1667 1674 1696 1712 1731 1741 1767 1780 1808 1808 1822 1830 1833 1831 1844 1840 1829 1835 1834 1833 1845 1842 
975 983 996 985 985 979 970 969 964 972 987 999 1002 1022 1040 1048 1054 1081 1115 1133 1136 1185 1214 1238 1259 1282 1305 1310 1307 1330 1348 1358 1365 1404 1438 1465 1474 1532 1566 1573 1584 1613 1639 1648 1652 1678 1691 1710 1722 1746 1780 1776 1770 1791 1815 1803 1794 1807 1820 1810 1815 1807 1802 1814 1818 
955 969 966 967 976 977 969 957 957 963 971 995 1000 1022 1016 1027 1030 1054 1074 1111 1140 1184 1188 1230 1249 1277 1277 1301 1300 1306 1316 1341 1345 1388 1405 1455 1478 1524 1522 1564 1578 1604 1610 1637 1656 1676 1678 1697 1698 1718 1725 1746 1751 1757 1763 1772 1770 1770 1771 1778 1778 1779 1787 1792 1799 
921 945 954 961 966 964 958 951 938 954 963 977 999 1005 1015 1009 1002 1041 1078 1109 1150 1171 1204 1229 1275 1265 1272 1280 1289 1298 1313 1319 1306 1368 1413 1449 1495 1504 1529 1548 1579 1591 1616 1636 1675 1677 1689 1689 1688 1707 1716 1723 1721 1737 1755 1745 1725 1740 1743 1745 1737 1753 1762 1772 1788 
932 936 945 958 954 957 958 953 956 955 944 952 962 987 992 994 1011 1032 1044 1099 1104 1148 1172 1210 1208 1238 1249 1261 1270 1285 1300 1317 1334 1368 1380 1433 1431 1470 1491 1523 1532 1568 1584 1617 1627 1668 1674 1683 1690 1707 1704 1712 1712 1718 1723 1728 1728 1724 1723 1722 1730 1735 1735 1747 1751 
939 943 965 954 948 953 958 955 959 948 931 943 948 971 988 993 1004 1026 1046 1081 1093 1141 1180 1185 1183 1204 1222 1245 1262 1283 1311 1320 1340 1371 1414 1419 1411 1449 1478 1497 1508 1545 1572 1599 1607 1645 1671 1678 1684 1696 1710 1707 1702 1714 1728 1716 1706 1711 1723 1715 1720 1719 1721 1715 1718 
934 933 938 948 952 949 948 952 951 947 949 941 942 962 969 988 995 1023 1043 1086 1106 1145 1141 1168 1168 1176 1194 1235 1242 1274 1283 1312 1325 1362 1375 1420 1429 1438 1445 1482 1495 1532 1550 1602 1612 1636 1643 1674 1669 1683 1689 1704 1710 1711 1703 1704 1703 1694 1697 1696 1700 1703 1689 1677 1680 
931 930 932 942 949 948 943 947 949 948 949 946 936 958 979 980 983 1022 1059 1093 1147 1142 1160 1158 1149 1166 1185 1215 1240 1257 1284 1296 1315 1345 1379 1407 1446 1442 1452 1470 1490 1526 1558 1594 1641 1640 1658 1658 1651 1672 1688 1701 1717 1707 1697 1694 1687 1689 1692 1686 1681 1672 1658 1652 1646 
916 926 928 940 939 951 948 945 944 948 951 959 958 957 960 970 986 1026 1037 1080 1077 1116 1138 1157 1156 1154 1166 1201 1201 1230 1246 1276 1287 1325 1341 1384 1391 1432 1441 1458 1482 1526 1538 1575 1582 1626 1639 1652 1660 1668 1672 1697 1691 1703 1700 1690 1690 1686 1682 1678 1661 1646 1635 1628 1621 
892 905 917 923 933 938 948 945 943 948 951 959 968 968 980 972 972 1015 1060 1062 1054 1102 1135 1146 1154 1157 1161 1181 1189 1220 1241 1255 1265 1303 1342 1362 1372 1406 1429 1459 1494 1526 1564 1572 1570 1613 1637 1653 1662 1669 1674 1681 1677 1691 1690 1687 1687 1678 1680 1655 1629 1613 1586 1590 1591 
877 888 893 903 911 920 931 944 950 952 952 959 960 970 968 966 973 1002 1015 1054 1071 1103 1105 1139 1144 1159 1166 1175 1191 1222 1217 1240 1250 1282 1303 1350 1364 1392 1411 1455 1478 1523 1540 1580 1596 1620 1626 1662 1668 1674 1677 1677 1684 1695 1686 1682 1673 1659 1654 1635 1626 1594 1586 1557 1555 
853 877 891 899 904 917 929 944 959 956 957 959 962 967 970 960 944 992 1032 1052 1070 1099 1124 1135 1144 1160 1178 1186 1207 1216 1220 1232 1237 1278 1317 1346 1372 1397 1427 1462 1505 1530 1564 1589 1623 1632 1653 1671 1699 1689 1696 1688 1693 1692 1690 1678 1663 1653 1638 1623 1596 1585 1566 1546 1517 
